WWWWWWWWWWWWWWWWWWWWWWWWWWWWWWWWWWWWWWWWWWWWWWWWWWWWWWWWWWWW
WWWWWWWWWWWWWWWWWWWWWWWWWWWWWWWWWWWWWWWWWWWWWWWWWWWWWWWWWWWW
WWWWWWWWWWWWWWWWWWWWWWWWWWWWWWWWWWWWWWWWWWWWWWWWWWWWWWWWWWWW
WWWWWWWWWWWWWWWWWWWWWWWWWWWWWWWWWWWWWWWWWWWWWWWWWWWWWWWWWWWW
WWWWWWWWWWWWWWWWWWWWWWWWWWWWWWWWW******WWWWWWWWWWWWWWWWWWWWW
WWWWWWWWWWWWW***WWWWWWWWWWWWW***************WWWWWWWWWWWWWWWW
WWWWWWWWWWWWW*****WWWWWWW****************************WWWWWWW
WWWWWWWWWWWWW********************************************WWW
WWWWWWWWWWWWW***************WWWWWW***********************WWW
WWWWWWWWWWWWWW**************WWWWWW*************************F
WWWWWWWWWWWWWWW************WWWWWWWWW***********************F
WWWWWWWWWWWWWWWW***********WWWWWWWWW***********************F
WWWWWWWWWWWWWWWW************WWHHWW***********************WWW
WWWWWWWWWWWWWWWW************WW**WW***********************WWW
WWWWWWWWWWWWWWWW*****************************************WWW
WWWWWWWWWWWWWWWW*****************************************WWW
WWWWWWWWWWWWWWWW*****************************************WWW
WWWWWWWWWWWWWWW****************************************WWWWW
WWWWWWWWWWWWW*****************************************WWWWWW
WWWWWWWWWWWW******************************************WWWWWW
WWWWWWWWW*********************************************WWWWWW
WWWWWWWWW*********************************************WWWWWW
WWWWWWWW*********************************************WWWWWWW
WWWWWWWW********************************************WWWWWWWW
WWWWWWWW********************************************WWWWWWWW
WWWWWWWW*******************************************WWWWWWWWW
WWWWWWW******************************************WWWWWWWWWW
WWWWWW********WWWWWWWWWW************************WWWWWWWWWWWW
WWWWWW********WWWWWWWWWWWWW********************WWWWWWWWWWWWW
WWWWWWWWWWWWWWWWWWWWWWWWWWWWWWWWWWWW**********WWWWWWWWWWWWWW
WWWWWWWWWWWWWWWWWWWWWWWWWWWWWWWWWWWWWWWW****WWWWWWWWWWWWWWWW
WWWWWWWWWWWWWWWWWWWWWWWWWWWWWWWWWWWWWWWWWWWWWWWWWWWWWWWWWWWW
WWWWWWWWWWWWWWWWWWWWWWWWWWWWWWWWWWWWWWWWWWWWWWWWWWWWWWWWWWWW
WWWWWWWWWWWWWWWWWWWWWWWWWWWWWWWWWWWWWWWWWWWWWWWWWWWWWWWWWWWW